##################
#................#
#................#
#................#
###..#######..####
#................#
#................#
############...###
#................#
#................#
###...############
#................#
#................#
##################

